NO textures/self/heavy/lego.xpm
SO textures/self/heavy/lego.xpm
WE textures/self/heavy/lego.xpm
EA textures/self/heavy/lego.xpm
BO textures/self/heavy/legorosa.xpm

F 34,139,34
C 70,130,180


11111111111111111111111111111111111
10000000000000000000000000000000001
10000000000000020000000000000200001
10200000000000000000000000000000001
10000000200000000000000200000000001
10020000000000000000000000000000001
10000000000000000000000000000000001
10000000000200000200000000000000001
10000000000000000000020000000000001
10000200000000000000000000000200001
100000000000000N0000000000000000001
11111111111111111111111111111111111