NO textures/other/wolfenstein/grey_stone.xpm
SO textures/other/wolfenstein/grey_stone.xpm
WE textures/other/wolfenstein/grey_stone.xpm
EA textures/other/wolfenstein/grey_stone.xpm

F 90,90,90
C 180,180,180


1111111111111111111111111
1E00000000000000000000001
1000000000000000000000001
1000000000000000000000001
1000000000000000000000001
1000000000000000000000001
1000000000000000000000001
1000000000000000000000001
1000000000000000000000001
1000000000000000000000001
1000000000000000000000001
1111111110111011111011111
1000100010001000100010001
1010101110101010101110101
1010001000100010001000101
1011111011111011111011111
1000001000001000001000001
1011101010111010111010111
1010001010001010001010001
1111111011111011111011111
1000001000100010001000001
1011101010101010101010111
1010001000100010001000101
1000001000001000001000001
1111111111111111111111111