NO textures/other/unknown/walls/stone1.xpm
SO textures/other/unknown/walls/stone3.xpm
WE textures/other/unknown/walls/stone2.xpm
EA textures/other/unknown/walls/stone2.xpm
BO textures/other/unknown/walls/wall4.xpm

F 70,70,70
C 190,200,210

1111111111111
1E00000000001
1000111111001
1110110011001
1100120000001
1000110011001
1000111111001
1000000000001
1001001111001
1001001011001
1001100010001
1001001000001
1111111111111

